******
*   +*
* # -*
*    *
******
