######
#   +#
# # -#
#    #
######
