*******
* ### *
*     *
*    +*
*******
