*******
*     *
* ### *
*    +*
*******
