*******
*     *
*     *
* ###+*
*******
